11111111111111111111111111111111111111111111111111
10000111000001000111110011000000000000001001110011
11000000000011000000000000000100000000101000010011
10000100000011000000000000010100110000001000010011
10101000000010000000011100010100000010001101010011
10101000001000000010010000111110000010001111111111
10101000001000111100111111000110001010001101111011
10000000001001111000000110000010001000000101000011
10001111111011110010000111000011111100000101000011
12000000101000000010000101000010001110000001000011
10000010101100000010000001100010001100001000000011
10100010111000000010011111111111111100101000000003
10000000111000100010001111001001000111001001000111
10000001110000100011001111001000000110000001100111
10010011111111110011000111001000011100000000010011
10010011111011111011000111011000000000010000010011
10110011111000101011001011011100010000010000011111
10110011010000111000000010010000010000010000010011
10100101000000010110000010011111000011111000010011
11111111111111111111111111111111111111111111111111
